15 30 10
6 5
??????????????????????????????
??????????????????????????????
??????????????????????????????
??????????????????????????????
???#####??????????????????????
???#####??????????????????????
???##T..??????????????????????
???#####??????????????????????
???#####??????????????????????
??????????????????????????????
??????????????????????????????
??????????????????????????????
??????????????????????????????
??????????????????????????????
??????????????????????????????
6 6
??????????????????????????????
??????????????????????????????
??????????????????????????????
??????????????????????????????
???######?????????????????????
???######?????????????????????
???##T...?????????????????????
???######?????????????????????
???######?????????????????????
??????????????????????????????
??????????????????????????????
??????????????????????????????
??????????????????????????????
??????????????????????????????
??????????????????????????????
6 7
??????????????????????????????
??????????????????????????????
??????????????????????????????
??????????????????????????????
???#######????????????????????
???#######????????????????????
???##T....????????????????????
???#######????????????????????
???#######????????????????????
??????????????????????????????
??????????????????????????????
??????????????????????????????
??????????????????????????????
??????????????????????????????
??????????????????????????????
6 8
??????????????????????????????
??????????????????????????????
??????????????????????????????
??????????????????????????????
???########???????????????????
???########???????????????????
???##T.....???????????????????
???########???????????????????
???########???????????????????
??????????????????????????????
??????????????????????????????
??????????????????????????????
??????????????????????????????
??????????????????????????????
??????????????????????????????
6 9
??????????????????????????????
??????????????????????????????
??????????????????????????????
??????????????????????????????
???#########??????????????????
???#########??????????????????
???##T......??????????????????
???#########??????????????????
???#########??????????????????
??????????????????????????????
??????????????????????????????
??????????????????????????????
??????????????????????????????
??????????????????????????????
??????????????????????????????
6 10
??????????????????????????????
??????????????????????????????
??????????????????????????????
??????????????????????????????
???##########?????????????????
???##########?????????????????
???##T......C?????????????????
???##########?????????????????
???##########?????????????????
??????????????????????????????
??????????????????????????????
??????????????????????????????
??????????????????????????????
??????????????????????????????
??????????????????????????????
6 11
??????????????????????????????
??????????????????????????????
??????????????????????????????
??????????????????????????????
???###########????????????????
???###########????????????????
???##T......C#????????????????
???###########????????????????
???###########????????????????
??????????????????????????????
??????????????????????????????
??????????????????????????????
??????????????????????????????
??????????????????????????????
??????????????????????????????
6 12
??????????????????????????????
??????????????????????????????
??????????????????????????????
??????????????????????????????
???############???????????????
???############???????????????
???##T......C##???????????????
???############???????????????
???############???????????????
??????????????????????????????
??????????????????????????????
??????????????????????????????
??????????????????????????????
??????????????????????????????
??????????????????????????????